                                                                       0
0000000000000000000000000000L 4556000M0000000000000000000000000000000000
0000000000000000000000000000L ;00700 M0000000000000000000000000000000000
0000000000000000000000000000L ;00700 M0000000000000000000000000000000000
0            000000000000000L ;00700 M0000000000000000000000000000000000
0 ONNNNNNNNP 000000000000000L ;00700 M0000000000000000000000000000000000
0 M00000000L 000000000000000L ;00700 M0000000000000000000000000000000000
0 M00000000L 000000000000000L ;00700 M0000000000000000000000000000000000
0 M0@AAAAB0L 000000000000000L ;00>60 M0000000000000000000000000000000000
0 M0DEEEEF0L 000000000000000L ;000>6 M0000000000000000000000000000000000
0 M0DEEEEF0L 000000000000000L ;00007 M0000000000000000000000000000000000
0 M0GDEEHC0L0000000000000000L :=0007 M0000000000000000000000000000000000
0 M00GHHC00L 000000000000000L 0:=00> M0000000000000000000000000000000000
0 M000@AB00L0005000000000000L 00;000 M0000000000000000000000000000000000
0 M00@AEFB0L 000000000000000L        M0000000000000000000000000000000000
0 M00DEEEF0L 0000000000000000NNNNNNNN00000000000000000000000000000000000
0 M00GHEEF0L 0000000000000000AAAAAAAAAAAAAAA2AAAAAAAAAAAAAAAAAAAAAAAAAAB
0 M000GHHC0L 000000000 000000EEEEEEEEEEEEEEEEEEEEEEEEEEEEEEEEEEEEEEEEEEF
0 M00@AB000L 000000000 000000HHHHHHHHHEEEEEEEEEEEEEEEEEEEEEEEEEEEEEEEEEF
0 M00DEF000L 0000000000000000JJJJJJJJ0HHHHHHHHHHHHHHHHHHHHHHHHHHHHHHHHHC
0 M0@AEF000L 000000000000000L0000;007M0000000000000000000000000000000000
0 M0DEEF000L 000000000000000L0000;007M0000000000000000000000000000000000
0 M0DEHC000L 000000000000000L0004?007M0000000000000000000000000000000000
0 M0GHC@AB0L 000000000000000L 04?000 M0000000000000000000000000000000000
0 M0000DEF0L 000000000000000L 0;000< M0000000000000000000000000000000000
0 M000DEEF0L 000000000000000L 4?00<8 M0000000000000000000000000000000000
0 M000GHHC0L 000000000000000L ;00070 M0000000000000000000000000000000000
0 M0000@AB0L 000000000000000L ;00070 M0000000000000000000000000000000000
0 M00@ADEF0L        00000000L ;00<80 M0000000000000000000000000000000000
0 M00DEEEEFL00000000 0000000L ;00700 M0000000000000000000000000000000000
0 M@ADEEEEF0N000000P 0000000L ;00700 M0000000000000000000000050000000000
0 MDEEEEEEE000@AB00L 0000000L ;00700 M0000000000000000000000000000000000
0 MDEEEEEEEEEFDEFABL 0000000L ;00700 M0000000000000000000000000000000000
0 MDEEEEEEEEEEEEEEFL 0000000L ;00700 M0000000000000000000000000000000000
0 MDEEEEEEEEEEEEEFIL 0000000L ;00700 M0000000000000000000000000000000000
0 MDEEEEEEEEEEEEFI0L 0000000L ;007000 M000000000000000000000000000000000
0 M0DEEFDEEFHHDEF00L 0000000L ;007000 M000000000000000000000000000000000
0 M0GHHIGHH000GHI00L 0000000L ;007000 M000000000000000000000000000000000
0 M0000000000000000L 0000000L ;007000 M000000000000000000000000000000000
0 M00 00000000 0000L 0000000L ;007000 MM00000000000000000000000000000000
0 M00M00000000 0000L 0000000L ;00>6000 M00000000000000000000000000000000
0 M00M00000000 0000L 0000000L ;000>560 M00000000000000000000000000000000
0 M00M00000000 0000L 0000000L ;00000>6 M00000000000000000000000000000000
0 M00M00000000 0000L 0000000L ;0000007 M00000000000000000000000000000000
0 M00M00000000 0000L 0000000L :=000007 MM0000000000000000000000000000000
0 M00000000000 0000L 00000000P :9=00070 M0000000000000000000000000000000
0 M000000000000P00000000000000P 0:=0070 M0000000000000000000000000000000
0 M000000000000L000000000000000P 0;0070 M0000000000000000000000000000000
0 MJJJJJJJJJJJJJJJJJ00000000000L 0;0070 M0000000000000000000000000000000
0                0  00000000000L 0;00>6 M0000000000000000000000000000000
             K                 L    3                                   
